V,E,L,C,R,I,C,S,
N,A,E,L,U,R,E,C,
E,L,P,R,U,P,U,E,
D,T,E,L,O,I,V,I,
I,E,U,D,J,C,V,W,
D,I,O,B,M,O,H,R,
E,T,E,L,R,A,C,S,
R,S,K,Y,B,L,U,E,

CERULEAN
CIRCLE
IVORY
PURPLE
RED
RHOMBOID
SCARLET
SKYBLUE
VIOLET
