K,T,O,O,L,S,A,L,
E,R,R,T,Q,U,A,Y,
G,P,O,U,V,O,R,R,
A,Y,I,W,C,E,S,E,
L,L,P,R,T,V,E,L,
L,P,A,T,J,R,O,L,
O,H,O,N,N,A,A,A,
C,P,W,A,Y,C,N,G,

ARTWORK
CARVE
COLLAGE
CHARCOAL
TOOLS
POTTERY
GALLERY
QUILL
