E,R,K,V,X,A,H,S,
S,E,N,Y,I,O,F,B,
N,C,E,Z,O,F,K,T,
E,C,E,P,O,I,R,A,
F,O,P,Y,O,I,D,R,
E,S,A,I,L,I,N,G,
D,L,D,B,O,C,C,E,
P,X,S,B,U,L,C,T,

BOCCE
HOOP
DEFENSE
CLUB
SAILING
TARGET
SOCCER
PLAYOFFS
KNEEPADS
