I,Y,R,A,D,E,M,O,R,D,
G,A,V,B,L,E,L,A,N,D,
U,H,K,A,N,G,A,R,O,O,
A,J,A,N,Y,U,Z,D,Z,N,
N,U,O,D,Y,B,O,A,R,Y,
A,Y,B,I,N,I,R,B,X,I,
P,O,R,C,U,P,I,N,E,S,
W,U,E,O,E,X,L,X,V,Z,
L,O,J,O,K,B,L,E,V,R,
G,R,S,T,D,V,A,K,I,P,

KANGAROO
PIKA
PORCUPINE
ZORILLA
IGUANA
JERBOA
ELAND
BANDICOOT
BOAR
DROMEDARY
