Y,N,A,I,R,O,B,I,
Q,D,L,Q,Q,A,T,N,
Y,K,H,M,N,D,A,B,
D,E,N,A,B,A,B,M,
B,B,V,V,K,P,A,G,
S,A,C,C,R,A,R,L,
H,K,B,O,G,O,T,A,
A,U,T,S,E,O,U,L,

BAKU
BOGOTA
ACCRA
DHAKA
HAVANA
MBABANE
NAIROBI
RABAT
SEOUL
