W,C,O,R,D,O,B,A,
I,O,G,R,P,I,T,F,
L,S,A,C,A,R,A,C,
Z,V,I,V,A,L,E,T,
L,A,T,A,K,L,O,K,
A,C,N,E,U,C,K,X,
A,R,A,M,A,S,B,C,
S,N,S,A,L,L,A,D,

CARACAS
CUENCA
CORDOBA
DALLAS
KOLKATA
SAMARA
SANTIAGO
TELAVIV
