K,K,T,Q,K,L,Z,F,
A,A,S,E,M,A,H,T,
T,I,T,I,C,A,C,A,
W,E,Y,V,W,E,E,K,
J,T,B,R,H,I,N,E,
R,E,P,E,I,N,D,O,
G,U,L,L,F,O,S,S,
N,R,I,J,I,F,P,W,

DNIEPER
FIJI
GULLFOSS
KAIETEUR
RHINE
TITICACA
THAMES
