N,I,A,L,P,A,H,C,
P,F,B,A,R,B,E,R,
A,S,Y,R,E,O,Z,E,
S,U,L,T,A,N,V,W,
T,N,A,H,C,R,E,M,
O,B,O,E,H,R,L,V,
R,V,E,T,E,R,A,N,
R,E,T,I,R,W,M,T,

PREACHER
WRITER
VETERAN
SULTAN
BARBER
CHAPLAIN
MERCHANT
PASTOR
