Y,A,T,T,I,L,A,M,L,A,
E,L,D,O,R,A,D,O,T,T,
A,N,A,S,E,N,C,M,O,L,
D,E,F,A,O,E,F,J,N,A,
E,L,N,A,P,O,L,E,A,N,
T,E,E,H,L,S,A,A,O,T,
T,I,E,D,Y,E,N,N,E,I,
R,E,U,L,L,W,N,S,R,S,
A,E,P,O,M,P,E,I,I,T,
R,P,H,B,E,G,L,C,T,A,

ATLANTIS
ELDORADO
POMPEII
ATTILA
NAPOLEAN
FLANNEL
MOMJEANS
TIEDYE
