U,K,U,N,S,T,D,L,
S,C,M,O,P,H,G,W,
L,H,B,C,A,L,L,Q,
F,I,R,E,W,O,O,D,
Y,M,E,T,W,Y,V,M,
E,N,L,H,J,F,E,R,
P,E,L,A,G,O,S,N,
C,Y,A,W,T,A,O,C,

CHIMNEY
FIREWOOD
COAT
GALE
GLOVES
UMBRELLA
THAW
