W,F,U,J,F,I,A,T,
E,I,D,E,C,G,D,L,
L,R,V,E,C,A,U,E,
T,E,K,N,A,L,B,M,
R,W,W,W,C,E,Z,Q,
B,O,K,T,I,P,C,O,
T,O,B,O,G,G,A,N,
V,D,B,H,G,U,O,C,

BLANKET
CAP
COUGH
FEVER
GALE
ICE
MELT
TOBOGGAN
FIREWOOD
