T,F,U,Z,Y,E,B,L,J,L,
L,R,I,G,X,L,O,A,X,T,
R,E,M,Q,V,B,U,S,W,E,
F,D,X,D,X,A,N,T,Z,W,
S,U,P,P,O,R,T,I,N,G,
C,T,I,Y,L,O,Y,N,O,J,
E,I,J,D,D,D,H,G,Z,M,
H,T,V,O,V,A,R,B,V,E,
G,P,E,I,K,B,E,U,J,T,
Z,A,Z,U,L,E,E,R,G,A,

APTITUDE
LASTING
BRAVO
CIVIL
BOUNTY
ADORABLE
SUPPORTING
AGREE
READY
JOKE
