B,B,N,O,O,L,Y,C,
P,T,U,I,Z,Z,T,R,
U,T,O,N,Z,R,E,A,
F,L,H,U,T,K,H,N,
F,N,S,R,C,I,Y,E,
I,J,R,I,U,A,N,S,
N,O,L,E,J,S,N,G,
G,F,D,W,T,S,H,L,

CRANE
JAY
BUNTING
FLICKER
LOON
PUFFIN
THRUSH
TERN
TOUCAN
