B,G,F,O,R,I,N,T,
I,O,T,V,C,O,A,R,
R,N,L,K,P,L,R,E,
W,R,A,I,I,C,B,A,
C,T,U,R,V,U,O,L,
S,V,A,G,A,A,D,F,
T,B,H,U,F,U,R,F,
K,X,Z,T,T,U,G,U,

BOLIVAR
DOBRA
GUARANI
LIRA
FORINT
REAL
TUGRIK
