N,R,A,T,I,U,G,L,
O,O,E,W,S,R,O,U,
D,N,L,P,F,G,F,T,
C,A,L,L,I,O,P,E,
A,E,U,R,I,P,C,X,
G,T,C,L,R,R,A,H,
E,P,Q,O,R,G,A,N,
B,V,Z,X,Z,E,H,C,

CALLIOPE
CARILLON
FLUTE
GUITAR
LUTE
ORGAN
PIPA
