H,N,V,P,V,D,A,A,
E,E,Y,Y,I,A,L,I,
A,R,L,M,L,K,A,F,
Y,A,L,S,N,A,P,O,
S,Y,R,A,I,R,M,S,
V,F,V,M,U,N,A,Z,
V,U,Y,V,S,P,K,V,
S,R,M,J,N,K,M,I,

DAKAR
HELSINKI
SOFIA
KAMPALA
SUVA
VILNIUS
YAREN
