N,D,T,Q,P,A,V,U,
I,N,H,D,Y,U,M,R,
G,A,A,B,H,K,A,U,
E,T,I,A,W,U,K,A,
R,L,L,V,L,R,N,N,
I,E,A,A,T,I,B,A,
A,P,N,F,H,A,I,M,
M,A,D,C,O,I,L,O,

CHINA
KUWAIT
LATVIA
LIBYA
NIGERIA
OMAN
THAILAND
