T,L,U,R,B,M,J,V,
E,B,S,V,A,U,L,T,
K,A,W,I,S,L,Y,T,
C,T,E,S,E,C,Q,C,
A,T,R,T,B,T,K,H,
R,I,C,Q,A,H,E,R,
Y,N,W,E,L,K,I,N,
I,G,G,Y,L,X,S,A,

BASEBALL
BATTING
NET
CREW
RACKET
VAULT
SKATE
