C,T,H,J,J,J,N,Z,
L,A,H,O,R,E,D,T,
S,C,O,N,O,G,E,E,
L,D,I,I,Y,Q,L,L,
R,S,E,T,K,V,H,A,
W,O,C,S,O,M,I,V,
Z,L,J,H,T,X,V,I,
E,P,R,A,G,U,E,V,

DELHI
LAHORE
MOSCOW
ONITSHA
PRAGUE
TELAVIV
TOKYO
