H,N,R,C,U,A,I,N,I,K,
S,N,O,U,Y,K,P,O,O,N,
I,A,O,C,T,Y,A,O,Z,A,
F,C,S,K,L,B,K,B,L,O,
Y,I,T,O,K,A,O,A,E,Z,
L,L,E,O,B,B,F,B,O,O,
L,E,R,U,L,H,T,Z,P,T,
E,P,R,L,Y,S,B,X,A,O,
J,R,P,F,J,U,Z,H,R,R,
A,V,C,T,T,B,W,N,D,P,

BABOON
BUSHBABY
CUCKOO
FALCON
JELLYFISH
KOOKABURRA
LEOPARD
OKAPI
PELICAN
PROTOZOAN
ROOSTER
