B,S,O,A,X,X,M,L,U,L,
B,T,U,S,S,A,A,B,G,I,
K,J,R,D,A,I,R,I,N,G,
X,P,A,E,V,V,M,E,I,H,
S,O,V,O,V,J,O,E,V,T,
K,S,J,L,A,I,O,R,I,E,
I,L,E,G,E,N,D,A,R,Y,
P,S,U,C,E,A,R,T,H,P,
Z,B,U,D,E,G,F,X,T,W,
M,A,Y,F,I,R,O,L,G,Y,

SAVOR
AIRING
LEGENDARY
JOVIAL
THRIVING
RECESS
GLORIFY
LIGHT
DIVERT
SKIP
