S,R,P,O,U,N,D,K,
F,O,K,E,P,C,C,U,
K,R,L,R,O,I,E,N,
E,R,H,L,O,P,D,A,
P,S,O,M,O,N,I,A,
G,N,F,N,P,V,E,A,
A,N,R,D,A,T,F,F,
A,W,H,O,A,L,A,T,

CEDI
COLON
KRONA
KRONE
KUNA
POUND
SOL
SOMONI
TALA
