T,T,R,E,N,G,T,G,
H,I,F,M,C,H,A,N,
T,G,X,L,A,U,I,O,
A,R,B,M,S,R,N,K,
G,I,E,C,P,U,L,E,
U,S,M,A,I,L,Z,M,
S,I,C,Q,A,U,A,A,
T,M,K,Q,N,Y,Z,E,

CAPRI
TAGUS
CASPIAN
MEKONG
THAMES
TIGRIS
ULURU
