U,S,T,H,G,I,T,M,
D,U,A,T,I,E,S,U,
B,E,A,N,I,E,V,U,
T,U,S,Z,D,Q,D,M,
U,W,T,O,Y,A,N,U,
U,K,Z,T,H,U,L,U,
U,N,I,F,O,R,M,S,
N,I,A,R,T,N,A,F,

BEANIE
HOSE
BUTTON
MUUMUU
SANDALS
TRAIN
TIGHTS
UNIFORM
TIE
