J,A,C,H,I,M,E,S,
P,B,A,S,S,O,O,N,
I,U,L,Z,P,W,H,I,
O,T,L,C,I,A,M,Y,
T,R,I,A,N,G,L,E,
R,E,O,W,E,Q,C,G,
O,U,P,D,T,K,I,O,
Y,M,E,O,O,Z,A,K,

BASSOON
CALLIOPE
KAZOO
CHIMES
SPINET
TRIANGLE
TUBA
