G,O,A,G,F,M,A,G,
E,B,F,D,Z,I,B,W,
J,S,E,W,N,A,J,O,
G,A,I,L,H,A,C,I,
X,D,R,R,G,A,W,K,
D,N,A,L,N,I,F,R,
U,I,Q,O,Q,F,U,Y,
N,C,M,R,O,U,E,M,

BAHRAIN
FIJI
BELGIUM
FINLAND
IRAQ
MONACO
RWANDA
