F,T,A,R,P,O,N,Z,
L,L,L,S,O,S,D,Q,
I,E,N,O,L,A,B,A,
M,M,L,M,L,W,G,I,
P,S,L,W,O,F,U,S,
E,I,I,M,C,I,P,B,
T,E,R,N,K,S,P,G,
R,N,K,J,O,H,Y,A,

ABALONE
KRILL
GUPPY
LIMPET
POLLOCK
SAWFISH
TARPON
SMELT
