T,B,F,I,S,H,I,N,G,N,
E,O,S,R,Q,R,N,P,O,E,
C,Y,B,Q,E,T,S,I,B,Q,
H,F,Z,S,C,K,T,T,N,U,
N,R,U,S,E,C,A,H,A,I,
O,I,Z,E,E,H,N,O,T,P,
L,E,W,R,C,I,C,U,I,M,
O,N,I,N,S,L,E,G,O,E,
G,D,Y,S,W,D,Q,H,N,N,
Y,C,A,M,E,R,A,T,F,T,

THOUGHT
BOYFRIEND
EQUIPMENT
NATION
WEEK
CAMERA
DIRECTION
FISHING
USER
CHILD
TECHNOLOGY
INSTANCE
