D,N,D,T,M,H,B,R,
M,A,F,I,R,E,R,U,
R,G,U,U,U,X,O,I,
N,G,B,S,G,W,X,W,
F,O,O,T,B,A,L,L,
D,B,C,E,Y,E,E,T,
L,O,C,W,T,L,Z,S,
Y,T,E,U,Q,O,R,C,

BOCCE
FOOTBALL
CROQUET
RUGBY
TEE
TOBOGGAN
WETSUIT
