C,U,X,P,R,B,L,K,
O,G,X,F,G,Y,E,W,
N,K,B,Z,Y,T,L,R,
E,S,S,O,R,C,L,V,
I,X,I,A,H,C,A,S,
T,N,E,C,S,E,R,C,
Q,H,A,T,S,X,A,A,
C,A,G,N,I,R,P,V,

ARC
CONE
CRESCENT
CROSS
HEART
PARALLEL
RING
