P,X,R,B,U,N,T,I,N,G,
B,L,E,C,W,K,O,O,R,W,
O,P,H,E,A,S,A,N,T,A,
O,J,S,K,O,V,S,T,L,P,
T,B,I,R,D,H,O,U,S,E,
A,Y,F,S,C,O,W,L,G,N,
K,B,G,J,W,R,W,D,H,G,
C,A,N,A,R,Y,E,M,E,U,
O,T,I,L,S,L,I,S,N,I,
C,Z,K,D,F,J,N,V,T,N,

BIRDHOUSE
BUNTING
COCKATOO
CANARY
CREST
FLEDGE
HEN
KINGFISHER
OWL
PENGUIN
PHEASANT
ROOK
