M,F,A,T,T,I,T,F,
P,V,I,G,M,R,I,N,
H,O,N,N,O,U,T,S,
I,L,O,O,J,O,I,E,
P,G,P,K,A,S,C,D,
H,A,A,E,V,S,A,N,
I,P,L,M,E,I,C,A,
G,E,B,L,E,M,A,Z,

ANDES
LAPONIA
MEKONG
ELBE
MISSOURI
MOJAVE
TITICACA
PHIPHI
VOLGA
