I,H,T,Y,L,S,H,P,A,G,
H,Y,E,B,X,G,P,M,L,M,
E,H,Y,C,H,X,L,O,B,E,
T,T,R,Z,O,F,W,R,R,E,
I,L,A,G,G,I,I,R,W,T,
L,A,K,R,N,G,J,B,V,S,
O,E,P,G,E,N,I,U,S,E,
P,H,B,L,A,N,D,L,C,O,
N,R,M,O,N,Z,E,D,T,V,
Z,Y,C,N,A,F,T,V,Y,F,

ROMP
GENIUS
POLITE
SPORT
FANCY
GLOWING
HEALTHY
VENERATE
BLAND
ESTEEM
