C,S,G,S,V,K,M,V,
N,R,E,H,C,A,E,T,
B,M,A,Y,O,R,C,R,
S,H,E,I,K,H,H,E,
M,U,S,I,C,I,A,N,
V,S,U,L,T,A,N,I,
S,A,M,U,R,A,I,M,
L,Y,R,A,U,T,C,A,

ACTUARY
MAYOR
MECHANIC
MINER
MUSICIAN
SAMURAI
SULTAN
SHEIKH
TEACHER
