D,E,T,U,W,T,E,O,V,P,
E,S,A,H,O,N,O,R,E,D,
R,I,Y,D,N,I,C,E,P,A,
O,D,N,A,T,U,R,A,L,P,
T,A,C,K,X,W,D,T,E,M,
S,R,O,B,L,I,S,S,A,R,
E,A,P,A,K,Y,F,E,S,B,
R,P,L,T,A,E,D,I,A,K,
J,G,T,X,E,B,Y,F,N,Q,
P,T,D,D,R,I,V,E,T,M,

PARADISE
HONORED
NATURAL
PLEASANT
FIESTA
RESTORED
BLISS
IDEA
DRIVE
NICE
