W,I,E,G,J,U,M,Z,
O,W,B,I,U,F,H,P,
O,U,O,X,M,D,K,U,
L,N,R,T,P,Q,F,R,
E,O,N,E,S,I,E,S,
N,O,C,V,U,V,D,E,
S,V,C,Z,I,R,A,S,
O,U,E,I,T,W,O,B,

BOWTIE
ONESIES
JUMPSUIT
PURSE
ROBE
WOOLENS
SARI
