F,A,M,I,L,Y,T,S,
L,T,P,A,R,T,Y,W,
I,D,E,E,U,X,A,E,
S,G,I,G,D,K,G,O,
T,V,P,G,O,Y,T,M,
G,Q,Y,N,L,R,I,C,
Q,K,M,O,P,J,G,R,
F,U,H,G,H,F,D,P,

LIST
FAMILY
PARTY
EGGNOG
RUDOLPH
HOLY
PIE
