Y,L,D,N,E,I,R,F,B,C,
T,F,D,E,N,I,F,E,R,T,
R,G,N,E,L,I,A,A,G,M,
A,R,I,V,L,U,U,S,H,N,
N,Y,Y,V,T,P,C,T,J,C,
Q,N,D,I,I,D,K,I,J,V,
U,N,F,E,U,N,M,N,D,V,
I,U,B,D,V,J,G,T,F,W,
L,S,S,E,D,M,L,A,C,G,
Y,R,R,E,M,M,Y,P,W,B,

LUCID
TRANQUIL
SUNNY
FEAST
GIVING
REFINED
BEAUTIFUL
MERRY
CALM
FRIENDLY
